###############
#             #
# ### #-# ### #
#   # #E# #   #
#   # ### #   #
#             #
# #   ###   # #
# #   #C#   # #
# #         # #
#     # #     #
#     ###     #
# ###     ### #
# #   ###   # #
#             #
###############
